List of parser fully qualified class names (26. April 2018)
------------------------------------------------------------------
AttrParser               : Mxc\Parsec\Qi\Auxiliary\AttrParser
EoiParser                : Mxc\Parsec\Qi\Auxiliary\EoiParser
EolParser                : Mxc\Parsec\Qi\Auxiliary\EolParser
EpsParser                : Mxc\Parsec\Qi\Auxiliary\EpsParser
LazyParser               : Mxc\Parsec\Qi\Auxiliary\LazyParser
LitParser                : Mxc\Parsec\Qi\Auxiliary\LitParser
RuleReference            : Mxc\Parsec\Qi\Auxiliary\RuleReference
BigBinDoubleParser       : Mxc\Parsec\Qi\Binary\BigBinDoubleParser
BigBinFloatParser        : Mxc\Parsec\Qi\Binary\BigBinFloatParser
BigDWordParser           : Mxc\Parsec\Qi\Binary\BigDWordParser
BigQWordParser           : Mxc\Parsec\Qi\Binary\BigQWordParser
BigWordParser            : Mxc\Parsec\Qi\Binary\BigWordParser
BinDoubleParser          : Mxc\Parsec\Qi\Binary\BinDoubleParser
BinFloatParser           : Mxc\Parsec\Qi\Binary\BinFloatParser
ByteParser               : Mxc\Parsec\Qi\Binary\ByteParser
DWordParser              : Mxc\Parsec\Qi\Binary\DWordParser
LittleBinDoubleParser    : Mxc\Parsec\Qi\Binary\LittleBinDoubleParser
LittleBinFloatParser     : Mxc\Parsec\Qi\Binary\LittleBinFloatParser
LittleDWordParser        : Mxc\Parsec\Qi\Binary\LittleDWordParser
LittleQWordParser        : Mxc\Parsec\Qi\Binary\LittleQWordParser
LittleWordParser         : Mxc\Parsec\Qi\Binary\LittleWordParser
QWordParser              : Mxc\Parsec\Qi\Binary\QWordParser
WordParser               : Mxc\Parsec\Qi\Binary\WordParser
AlnumParser              : Mxc\Parsec\Qi\Char\AlnumParser
AlphaParser              : Mxc\Parsec\Qi\Char\AlphaParser
BlankParser              : Mxc\Parsec\Qi\Char\BlankParser
CharClassParser          : Mxc\Parsec\Qi\Char\CharClassParser
CharParser               : Mxc\Parsec\Qi\Char\CharParser
CharRangeParser          : Mxc\Parsec\Qi\Char\CharRangeParser
CharSetParser            : Mxc\Parsec\Qi\Char\CharSetParser
CntrlParser              : Mxc\Parsec\Qi\Char\CntrlParser
DigitParser              : Mxc\Parsec\Qi\Char\DigitParser
GraphParser              : Mxc\Parsec\Qi\Char\GraphParser
LowerParser              : Mxc\Parsec\Qi\Char\LowerParser
PrintParser              : Mxc\Parsec\Qi\Char\PrintParser
PunctParser              : Mxc\Parsec\Qi\Char\PunctParser
SpaceParser              : Mxc\Parsec\Qi\Char\SpaceParser
UpperParser              : Mxc\Parsec\Qi\Char\UpperParser
XDigitParser             : Mxc\Parsec\Qi\Char\XDigitParser
AsStringDirective        : Mxc\Parsec\Qi\Directive\AsStringDirective
ExpectDirective          : Mxc\Parsec\Qi\Directive\ExpectDirective
HoldDirective            : Mxc\Parsec\Qi\Directive\HoldDirective
LexemeDirective          : Mxc\Parsec\Qi\Directive\LexemeDirective
MatchesDirective         : Mxc\Parsec\Qi\Directive\MatchesDirective
NoCaseDirective          : Mxc\Parsec\Qi\Directive\NoCaseDirective
NoSkipDirective          : Mxc\Parsec\Qi\Directive\NoSkipDirective
OmitDirective            : Mxc\Parsec\Qi\Directive\OmitDirective
RawDirective             : Mxc\Parsec\Qi\Directive\RawDirective
RepeatDirective          : Mxc\Parsec\Qi\Directive\RepeatDirective
SkipDirective            : Mxc\Parsec\Qi\Directive\SkipDirective
Grammar                  : Mxc\Parsec\Qi\NonTerminal\Grammar
Rule                     : Mxc\Parsec\Qi\NonTerminal\Rule
BinaryParser             : Mxc\Parsec\Qi\Numeric\BinaryParser
BoolParser               : Mxc\Parsec\Qi\Numeric\BoolParser
DoubleParser             : Mxc\Parsec\Qi\Numeric\DoubleParser
FalseParser              : Mxc\Parsec\Qi\Numeric\FalseParser
FloatParser              : Mxc\Parsec\Qi\Numeric\FloatParser
HexParser                : Mxc\Parsec\Qi\Numeric\HexParser
IntParser                : Mxc\Parsec\Qi\Numeric\IntParser
LongDoubleParser         : Mxc\Parsec\Qi\Numeric\LongDoubleParser
LongLongParser           : Mxc\Parsec\Qi\Numeric\LongLongParser
LongParser               : Mxc\Parsec\Qi\Numeric\LongParser
OctParser                : Mxc\Parsec\Qi\Numeric\OctParser
ShortParser              : Mxc\Parsec\Qi\Numeric\ShortParser
TrueParser               : Mxc\Parsec\Qi\Numeric\TrueParser
UIntParser               : Mxc\Parsec\Qi\Numeric\UIntParser
ULongLongParser          : Mxc\Parsec\Qi\Numeric\ULongLongParser
ULongParser              : Mxc\Parsec\Qi\Numeric\ULongParser
UShortParser             : Mxc\Parsec\Qi\Numeric\UShortParser
AlternativeOperator      : Mxc\Parsec\Qi\Operator\AlternativeOperator
AndPredicate             : Mxc\Parsec\Qi\Operator\AndPredicate
DifferenceOperator       : Mxc\Parsec\Qi\Operator\DifferenceOperator
ExpectOperator           : Mxc\Parsec\Qi\Operator\ExpectOperator
KleeneOperator           : Mxc\Parsec\Qi\Operator\KleeneOperator
ListOperator             : Mxc\Parsec\Qi\Operator\ListOperator
NotPredicate             : Mxc\Parsec\Qi\Operator\NotPredicate
OptionalOperator         : Mxc\Parsec\Qi\Operator\OptionalOperator
PermutationOperator      : Mxc\Parsec\Qi\Operator\PermutationOperator
PlusOperator             : Mxc\Parsec\Qi\Operator\PlusOperator
SequenceOperator         : Mxc\Parsec\Qi\Operator\SequenceOperator
SequentialOrOperator     : Mxc\Parsec\Qi\Operator\SequentialOrOperator
AdvanceParser            : Mxc\Parsec\Qi\Repository\Auxiliary\AdvanceParser
DistinctDirective        : Mxc\Parsec\Qi\Repository\Directive\DistinctDirective
StringParser             : Mxc\Parsec\Qi\String\StringParser
SymbolsParser            : Mxc\Parsec\Qi\String\SymbolsParser
